Driver eFuse Map From HW
0x00	29 81 00 8F FF 00 09 00 	9A 04 E4 31 10 03 F1 E8 
0x10	FF FF FF FF FF FF FF FF 	FF FF FF FF FF FF FF FF 
0x20	FF FF 4A 4A 4A 4A 36 36 	36 36 36 36 44 48 4C 50 
0x30	12 EE FF FF F0 FF F0 E0 	FF FF FF FF FF FF FF FF 
0x40	FF FF FF FF FF FF FF FF 	FF FF FF FF 51 51 51 51 
0x50	3F 3F 3F 3F 3F 3F 3E 41 	44 47 12 EE FF FF F0 FF 
0x60	F0 E0 FF FF FF FF FF FF 	FF FF FF FF FF FF FF FF 
0x70	FF FF FF FF FF FF FF FF 	FF FF FF FF FF FF FF FF 
0x80	FF FF FF FF FF FF FF FF 	FF FF FF FF FF FF FF FF 
0x90	FF FF FF FF FF FF FF FF 	FF FF FF FF FF FF FF FF 
0xa0	FF FF FF FF FF FF FF FF 	FF FF FF FF FF FF FF FF 
0xb0	FF FF FF FF FF FF FF FF 	7F 3C FF 00 FF FF FF FF 
0xc0	FF 01 00 10 00 00 FF FF 	00 33 15 FF FF FF FF FF 
0xd0	13 13 FF FF FF FF FF FF 	FF FF FF FF FF FF FF FF 
0xe0	FF FF FF FF FF FF FF FF 	FF FF FF FF FF FF FF FF 
0xf0	FF FF FF FF FF FF FF FF 	FF FF FF FF FF FF FF FF 
0x100	F0 F8 A5 D3 88 C8 64 0C 	0D F0 FF FF FF FF FF FF 
0x110	3C 3C FC 90 D8 D8 FD FF 	35 9D FF FF FF FF FF FF 
0x120	FF FF FF FF FF FF FF FF 	FF FF FF FF FF FF FF FF 
0x130	FF FF FF FF FF FF FF FF 	FF FF FF FF FF FF FF FF 
0x140	FF FF FF FF FF FF FF FF 	FF FF FF FF FF FF FF FF 
0x150	DA 0B 1A A8 FF 7E 02 78 	22 88 D9 93 E6 09 03 52 
0x160	65 61 6C 74 65 6B 0E 03 	38 30 32 2E 31 31 61 63 
0x170	20 4E 49 43 08 03 31 32 	33 34 35 36 FF FF FF FF 
0x180	FF FF FF FF FF FF FF FF 	FF FF FF FF FF FF FF FF 
0x190	BD FE FF FF 00 00 21 0F 	FF FF FF FF FF FF FF FF 
0x1a0	FF FF FF FF FF FF FF FF 	FF FF FF FF FF FF FF FF 
0x1b0	FF FF FF FF FF FF FF FF 	FF FF FF FF FF FF FF FF 
0x1c0	FF FF FF FF FF FF FF FF 	FF FF FF FF FF FF FF FF 
0x1d0	FF FF FF FF FF FF FF FF 	FF FF FF FF FF FF FF FF 
0x1e0	FF FF FF FF FF FF FF FF 	FF FF FF FF FF FF FF FF 
0x1f0	FF FF FF FF FF FF FF FF 	FF FF FF FF FF FF FF FF 
0x200	9B 58 9B CD 6C 71 01 71 	25 70 88 31 48 0F 58 E3 
0x210	FF FF 00 00 15 81 53 48 	EC 8C 00 11 9B 15 00 0A 
0x220	00 49 40 FF FF FF FF FF 	FF FF FF FF FF FF FF FF 
0x230	FF FF FF FF FF FF FF FF 	FF FF FF FF FF FF FF FF 
0x240	FF FF FF FF FF FF FF FF 	FF FF FF FF FF FF FF FF 
0x250	FF FF FF FF FF FF FF FF 	FF FF FF FF FF FF FF FF 
0x260	FF FF FF FF FF FF FF FF 	FF FF FF FF FF FF FF FF 
0x270	FF FF FF FF FF FF FF FF 	FF FF FF FF FF FF FF FF 
0x280	FF FF FF FF FF FF FF FF 	FF FF FF FF FF FF FF FF 
0x290	FF FF FF FF FF FF FF FF 	FF FF FF FF FF FF FF FF 
0x2a0	FF FF FF FF FF FF FF FF 	FF FF FF FF FF FF FF FF 
0x2b0	FF FF FF FF FF FF FF FF 	FF FF FF FF FF FF FF FF 
0x2c0	FF FF FF FF FF FF FF FF 	FF FF FF FF FF FF FF FF 
0x2d0	FF FF FF FF FF FF FF FF 	FF FF FF FF FF FF FF FF 
0x2e0	FF FF FF FF FF FF FF FF 	FF FF FF FF FF FF FF FF 
0x2f0	FF FF FF FF FF FF FF FF 	FF FF FF FF FF FF FF FF 
0x300	FF FF FF FF FF FF FF FF 	FF FF FF FF FF FF FF FF 
0x310	FF FF FF FF FF FF FF FF 	FF FF FF FF FF FF FF FF 
0x320	FF FF FF FF FF FF FF FF 	FF FF FF FF FF FF FF FF 
0x330	FF FF FF FF FF FF FF FF 	FF FF FF FF FF FF FF FF 
0x340	FF FF FF FF FF FF FF FF 	FF FF FF FF FF FF FF FF 
0x350	FF FF FF FF FF FF FF FF 	FF FF FF FF FF FF FF FF 
0x360	FF FF FF FF FF FF FF FF 	FF FF FF FF FF FF FF FF 
0x370	FF FF FF FF FF FF FF FF 	FF FF FF FF FF FF FF FF 
0x380	FF FF FF FF FF FF FF FF 	FF FF FF FF FF FF FF FF 
0x390	FF FF FF FF FF FF FF FF 	FF FF FF FF FF FF FF FF 
0x3a0	FF FF FF FF FF FF FF FF 	FF FF FF FF FF FF FF FF 
0x3b0	FF FF FF FF FF FF FF FF 	FF FF FF FF FF FF FF FF 
0x3c0	FF FF FF FF FF FF FF FF 	FF FF FF FF FF FF FF FF 
0x3d0	FF FF FF FF FF FF FF FF 	FF FF FF FF FF FF FF FF 
0x3e0	FF FF FF FF FF FF FF FF 	FF FF FF FF FF FF FF FF 
0x3f0	FF FF FF FF FF FF FF FF 	FF FF FF FF FF FF FF FF 
0x400	FF FF FF FF FF FF FF FF 	FF FF FF FF FF FF FF FF 
0x410	FF FF FF FF FF FF FF FF 	FF FF FF FF FF FF FF FF 
0x420	FF FF FF FF FF FF FF FF 	FF FF FF FF FF FF FF FF 
0x430	FF FF FF FF FF FF FF FF 	FF FF FF FF FF FF FF FF 
0x440	FF FF FF FF FF FF FF FF 	FF FF FF FF FF FF FF FF 
0x450	FF FF FF FF FF FF FF FF 	FF FF FF FF FF FF FF FF 
0x460	FF FF FF FF FF FF FF FF 	FF FF FF FF FF FF FF FF 
0x470	FF FF FF FF FF FF FF FF 	FF FF FF FF FF FF FF FF 
0x480	FF FF FF FF FF FF FF FF 	FF FF FF FF FF FF FF FF 
0x490	FF FF FF FF FF FF FF FF 	FF FF FF FF FF FF FF FF 
0x4a0	FF FF FF FF FF FF FF FF 	FF FF FF FF FF FF FF FF 
0x4b0	FF FF FF FF FF FF FF FF 	FF FF FF FF FF FF FF FF 
0x4c0	FF FF FF FF FF FF FF FF 	FF FF FF FF FF FF FF FF 
0x4d0	FF FF FF FF FF FF FF FF 	FF FF FF FF FF FF FF FF 
0x4e0	FF FF FF FF FF FF FF FF 	FF FF FF FF FF FF FF FF 
0x4f0	FF FF FF FF FF FF FF FF 	FF FF FF FF FF FF FF FF 
0x500	FF FF FF FF FF FF FF FF 	FF FF FF FF FF FF FF FF 
0x510	FF FF FF FF FF FF FF FF 	FF FF FF FF FF FF FF FF 
0x520	FF FF FF FF FF FF FF FF 	FF FF FF FF FF FF FF FF 
0x530	FF FF FF FF FF FF FF FF 	FF FF FF FF FF FF FF FF 
0x540	FF FF FF FF FF FF FF FF 	FF FF FF FF FF FF FF FF 
0x550	FF FF FF FF FF FF FF FF 	FF FF FF FF FF FF FF FF 
0x560	FF FF FF FF FF FF FF FF 	FF FF FF FF FF FF FF FF 
0x570	FF FF FF FF FF FF FF FF 	FF FF FF FF FF FF FF FF 
0x580	FF FF FF FF FF FF FF FF 	FF FF FF FF FF FF FF FF 
0x590	FF FF FF FF FF FF FF FF 	FF FF FF FF FF FF FF FF 
0x5a0	FF FF FF FF FF FF FF FF 	FF FF FF FF FF FF FF FF 
0x5b0	FF FF FF FF FF FF FF FF 	FF FF FF FF FF FF FF FF 
0x5c0	FF FF FF FF FF FF FF FF 	FF FF FF FF FF FF FF FF 
0x5d0	FF FF FF FF FF FF FF FF 	FF FF FF FF FF FF FF FF 
0x5e0	FF FF FF FF FF FF FF FF 	FF FF FF FF FF FF FF FF 
0x5f0	FF FF FF FF FF FF FF FF 	FF FF FF FF FF FF FF FF 
0x600	FF FF FF FF FF FF FF FF 	FF FF FF FF FF FF FF FF 
0x610	FF FF FF FF FF FF FF FF 	FF FF FF FF FF FF FF FF 
0x620	FF FF FF FF FF FF FF FF 	FF FF FF FF FF FF FF FF 
0x630	FF FF FF FF FF FF FF FF 	FF FF FF FF FF FF FF FF 
0x640	FF FF FF FF FF FF FF FF 	FF FF FF FF FF FF FF FF 
0x650	FF FF FF FF FF FF FF FF 	FF FF FF FF FF FF FF FF 
0x660	FF FF FF FF FF FF FF FF 	FF FF FF FF FF FF FF FF 
0x670	FF FF FF FF FF FF FF FF 	FF FF FF FF FF FF FF FF 
0x680	FF FF FF FF FF FF FF FF 	FF FF FF FF FF FF FF FF 
0x690	FF FF FF FF FF FF FF FF 	FF FF FF FF FF FF FF FF 
0x6a0	FF FF FF FF FF FF FF FF 	FF FF FF FF FF FF FF FF 
0x6b0	FF FF FF FF FF FF FF FF 	FF FF FF FF FF FF FF FF 
0x6c0	FF FF FF FF FF FF FF FF 	FF FF FF FF FF FF FF FF 
0x6d0	FF FF FF FF FF FF FF FF 	FF FF FF FF FF FF FF FF 
0x6e0	FF FF FF FF FF FF FF FF 	FF FF FF FF FF FF FF FF 
0x6f0	FF FF FF FF FF FF FF FF 	FF FF FF FF FF FF FF FF 
0x700	FF FF FF FF FF FF FF FF 	FF FF FF FF FF FF FF FF 
0x710	FF FF FF FF FF FF FF FF 	FF FF FF FF FF FF FF FF 
0x720	FF FF FF FF FF FF FF FF 	FF FF FF FF FF FF FF FF 
0x730	FF FF FF FF FF FF FF FF 	FF FF FF FF FF FF FF FF 
0x740	FF FF FF FF FF FF FF FF 	FF FF FF FF FF FF FF FF 
0x750	FF FF FF FF FF FF FF FF 	FF FF FF FF FF FF FF FF 
0x760	FF FF FF FF FF FF FF FF 	FF FF FF FF FF FF FF FF 
0x770	FF FF FF FF FF FF FF FF 	FF FF FF FF FF FF FF FF 
0x780	FF FF FF FF FF FF FF FF 	FF FF FF FF FF FF FF FF 
0x790	FF FF FF FF FF FF FF FF 	FF FF FF FF FF FF FF FF 
0x7a0	FF FF FF FF FF FF FF FF 	FF FF FF FF FF FF FF FF 
0x7b0	FF FF FF FF FF FF FF FF 	FF FF FF FF FF FF FF FF 
0x7c0	FF FF FF FF FF FF FF FF 	FF FF FF FF FF FF FF FF 
0x7d0	FF FF FF FF FF FF FF FF 	FF FF FF FF FF FF FF FF 
0x7e0	FF FF FF FF FF FF FF FF 	FF FF FF FF FF FF FF FF 
0x7f0	FF FF FF FF FF FF FF FF 	FF FF FF FF FF FF FF FF 

HW eFuse Map
0x00	29 81 00 8F FF 00 09 00 	9A 04 E4 31 10 03 F1 E8 
0x10	FF FF FF FF FF FF FF FF 	FF FF FF FF FF FF FF FF 
0x20	FF FF 4A 4A 4A 4A 36 36 	36 36 36 36 44 48 4C 50 
0x30	12 EE FF FF F0 FF F0 E0 	FF FF FF FF FF FF FF FF 
0x40	FF FF FF FF FF FF FF FF 	FF FF FF FF 51 51 51 51 
0x50	3F 3F 3F 3F 3F 3F 3E 41 	44 47 12 EE FF FF F0 FF 
0x60	F0 E0 FF FF FF FF FF FF 	FF FF FF FF FF FF FF FF 
0x70	FF FF FF FF FF FF FF FF 	FF FF FF FF FF FF FF FF 
0x80	FF FF FF FF FF FF FF FF 	FF FF FF FF FF FF FF FF 
0x90	FF FF FF FF FF FF FF FF 	FF FF FF FF FF FF FF FF 
0xa0	FF FF FF FF FF FF FF FF 	FF FF FF FF FF FF FF FF 
0xb0	FF FF FF FF FF FF FF FF 	7F 3C FF 00 FF FF FF FF 
0xc0	FF 01 00 10 00 00 FF FF 	00 33 15 FF FF FF FF FF 
0xd0	13 13 FF FF FF FF FF FF 	FF FF FF FF FF FF FF FF 
0xe0	FF FF FF FF FF FF FF FF 	FF FF FF FF FF FF FF FF 
0xf0	FF FF FF FF FF FF FF FF 	FF FF FF FF FF FF FF FF 
0x100	F0 F8 A5 D3 88 C8 64 0C 	0D F0 FF FF FF FF FF FF 
0x110	3C 3C FC 90 D8 D8 FD FF 	35 9D FF FF FF FF FF FF 
0x120	FF FF FF FF FF FF FF FF 	FF FF FF FF FF FF FF FF 
0x130	FF FF FF FF FF FF FF FF 	FF FF FF FF FF FF FF FF 
0x140	FF FF FF FF FF FF FF FF 	FF FF FF FF FF FF FF FF 
0x150	DA 0B 1A A8 FF 7E 02 78 	22 88 D9 93 E6 09 03 52 
0x160	65 61 6C 74 65 6B 0E 03 	38 30 32 2E 31 31 61 63 
0x170	20 4E 49 43 08 03 31 32 	33 34 35 36 FF FF FF FF 
0x180	FF FF FF FF FF FF FF FF 	FF FF FF FF FF FF FF FF 
0x190	BD FE FF FF 00 00 21 0F 	FF FF FF FF FF FF FF FF 
0x1a0	FF FF FF FF FF FF FF FF 	FF FF FF FF FF FF FF FF 
0x1b0	FF FF FF FF FF FF FF FF 	FF FF FF FF FF FF FF FF 
0x1c0	FF FF FF FF FF FF FF FF 	FF FF FF FF FF FF FF FF 
0x1d0	FF FF FF FF FF FF FF FF 	FF FF FF FF FF FF FF FF 
0x1e0	FF FF FF FF FF FF FF FF 	FF FF FF FF FF FF FF FF 
0x1f0	FF FF FF FF FF FF FF FF 	FF FF FF FF FF FF FF FF 
0x200	9B 58 9B CD 6C 71 01 71 	25 70 88 31 48 0F 58 E3 
0x210	FF FF 00 00 15 81 53 48 	EC 8C 00 11 9B 15 00 0A 
0x220	00 49 40 FF FF FF FF FF 	FF FF FF FF FF FF FF FF 
0x230	FF FF FF FF FF FF FF FF 	FF FF FF FF FF FF FF FF 
0x240	FF FF FF FF FF FF FF FF 	FF FF FF FF FF FF FF FF 
0x250	FF FF FF FF FF FF FF FF 	FF FF FF FF FF FF FF FF 
0x260	FF FF FF FF FF FF FF FF 	FF FF FF FF FF FF FF FF 
0x270	FF FF FF FF FF FF FF FF 	FF FF FF FF FF FF FF FF 
0x280	FF FF FF FF FF FF FF FF 	FF FF FF FF FF FF FF FF 
0x290	FF FF FF FF FF FF FF FF 	FF FF FF FF FF FF FF FF 
0x2a0	FF FF FF FF FF FF FF FF 	FF FF FF FF FF FF FF FF 
0x2b0	FF FF FF FF FF FF FF FF 	FF FF FF FF FF FF FF FF 
0x2c0	FF FF FF FF FF FF FF FF 	FF FF FF FF FF FF FF FF 
0x2d0	FF FF FF FF FF FF FF FF 	FF FF FF FF FF FF FF FF 
0x2e0	FF FF FF FF FF FF FF FF 	FF FF FF FF FF FF FF FF 
0x2f0	FF FF FF FF FF FF FF FF 	FF FF FF FF FF FF FF FF 
0x300	FF FF FF FF FF FF FF FF 	FF FF FF FF FF FF FF FF 
0x310	FF FF FF FF FF FF FF FF 	FF FF FF FF FF FF FF FF 
0x320	FF FF FF FF FF FF FF FF 	FF FF FF FF FF FF FF FF 
0x330	FF FF FF FF FF FF FF FF 	FF FF FF FF FF FF FF FF 
0x340	FF FF FF FF FF FF FF FF 	FF FF FF FF FF FF FF FF 
0x350	FF FF FF FF FF FF FF FF 	FF FF FF FF FF FF FF FF 
0x360	FF FF FF FF FF FF FF FF 	FF FF FF FF FF FF FF FF 
0x370	FF FF FF FF FF FF FF FF 	FF FF FF FF FF FF FF FF 
0x380	FF FF FF FF FF FF FF FF 	FF FF FF FF FF FF FF FF 
0x390	FF FF FF FF FF FF FF FF 	FF FF FF FF FF FF FF FF 
0x3a0	FF FF FF FF FF FF FF FF 	FF FF FF FF FF FF FF FF 
0x3b0	FF FF FF FF FF FF FF FF 	FF FF FF FF FF FF FF FF 
0x3c0	FF FF FF FF FF FF FF FF 	FF FF FF FF FF FF FF FF 
0x3d0	FF FF FF FF FF FF FF FF 	FF FF FF FF FF FF FF FF 
0x3e0	FF FF FF FF FF FF FF FF 	FF FF FF FF FF FF FF FF 
0x3f0	FF FF FF FF FF FF FF FF 	FF FF FF FF FF FF FF FF 
0x400	FF FF FF FF FF FF FF FF 	FF FF FF FF FF FF FF FF 
0x410	FF FF FF FF FF FF FF FF 	FF FF FF FF FF FF FF FF 
0x420	FF FF FF FF FF FF FF FF 	FF FF FF FF FF FF FF FF 
0x430	FF FF FF FF FF FF FF FF 	FF FF FF FF FF FF FF FF 
0x440	FF FF FF FF FF FF FF FF 	FF FF FF FF FF FF FF FF 
0x450	FF FF FF FF FF FF FF FF 	FF FF FF FF FF FF FF FF 
0x460	FF FF FF FF FF FF FF FF 	FF FF FF FF FF FF FF FF 
0x470	FF FF FF FF FF FF FF FF 	FF FF FF FF FF FF FF FF 
0x480	FF FF FF FF FF FF FF FF 	FF FF FF FF FF FF FF FF 
0x490	FF FF FF FF FF FF FF FF 	FF FF FF FF FF FF FF FF 
0x4a0	FF FF FF FF FF FF FF FF 	FF FF FF FF FF FF FF FF 
0x4b0	FF FF FF FF FF FF FF FF 	FF FF FF FF FF FF FF FF 
0x4c0	FF FF FF FF FF FF FF FF 	FF FF FF FF FF FF FF FF 
0x4d0	FF FF FF FF FF FF FF FF 	FF FF FF FF FF FF FF FF 
0x4e0	FF FF FF FF FF FF FF FF 	FF FF FF FF FF FF FF FF 
0x4f0	FF FF FF FF FF FF FF FF 	FF FF FF FF FF FF FF FF 
0x500	FF FF FF FF FF FF FF FF 	FF FF FF FF FF FF FF FF 
0x510	FF FF FF FF FF FF FF FF 	FF FF FF FF FF FF FF FF 
0x520	FF FF FF FF FF FF FF FF 	FF FF FF FF FF FF FF FF 
0x530	FF FF FF FF FF FF FF FF 	FF FF FF FF FF FF FF FF 
0x540	FF FF FF FF FF FF FF FF 	FF FF FF FF FF FF FF FF 
0x550	FF FF FF FF FF FF FF FF 	FF FF FF FF FF FF FF FF 
0x560	FF FF FF FF FF FF FF FF 	FF FF FF FF FF FF FF FF 
0x570	FF FF FF FF FF FF FF FF 	FF FF FF FF FF FF FF FF 
0x580	FF FF FF FF FF FF FF FF 	FF FF FF FF FF FF FF FF 
0x590	FF FF FF FF FF FF FF FF 	FF FF FF FF FF FF FF FF 
0x5a0	FF FF FF FF FF FF FF FF 	FF FF FF FF FF FF FF FF 
0x5b0	FF FF FF FF FF FF FF FF 	FF FF FF FF FF FF FF FF 
0x5c0	FF FF FF FF FF FF FF FF 	FF FF FF FF FF FF FF FF 
0x5d0	FF FF FF FF FF FF FF FF 	FF FF FF FF FF FF FF FF 
0x5e0	FF FF FF FF FF FF FF FF 	FF FF FF FF FF FF FF FF 
0x5f0	FF FF FF FF FF FF FF FF 	FF FF FF FF FF FF FF FF 
0x600	FF FF FF FF FF FF FF FF 	FF FF FF FF FF FF FF FF 
0x610	FF FF FF FF FF FF FF FF 	FF FF FF FF FF FF FF FF 
0x620	FF FF FF FF FF FF FF FF 	FF FF FF FF FF FF FF FF 
0x630	FF FF FF FF FF FF FF FF 	FF FF FF FF FF FF FF FF 
0x640	FF FF FF FF FF FF FF FF 	FF FF FF FF FF FF FF FF 
0x650	FF FF FF FF FF FF FF FF 	FF FF FF FF FF FF FF FF 
0x660	FF FF FF FF FF FF FF FF 	FF FF FF FF FF FF FF FF 
0x670	FF FF FF FF FF FF FF FF 	FF FF FF FF FF FF FF FF 
0x680	FF FF FF FF FF FF FF FF 	FF FF FF FF FF FF FF FF 
0x690	FF FF FF FF FF FF FF FF 	FF FF FF FF FF FF FF FF 
0x6a0	FF FF FF FF FF FF FF FF 	FF FF FF FF FF FF FF FF 
0x6b0	FF FF FF FF FF FF FF FF 	FF FF FF FF FF FF FF FF 
0x6c0	FF FF FF FF FF FF FF FF 	FF FF FF FF FF FF FF FF 
0x6d0	FF FF FF FF FF FF FF FF 	FF FF FF FF FF FF FF FF 
0x6e0	FF FF FF FF FF FF FF FF 	FF FF FF FF FF FF FF FF 
0x6f0	FF FF FF FF FF FF FF FF 	FF FF FF FF FF FF FF FF 
0x700	FF FF FF FF FF FF FF FF 	FF FF FF FF FF FF FF FF 
0x710	FF FF FF FF FF FF FF FF 	FF FF FF FF FF FF FF FF 
0x720	FF FF FF FF FF FF FF FF 	FF FF FF FF FF FF FF FF 
0x730	FF FF FF FF FF FF FF FF 	FF FF FF FF FF FF FF FF 
0x740	FF FF FF FF FF FF FF FF 	FF FF FF FF FF FF FF FF 
0x750	FF FF FF FF FF FF FF FF 	FF FF FF FF FF FF FF FF 
0x760	FF FF FF FF FF FF FF FF 	FF FF FF FF FF FF FF FF 
0x770	FF FF FF FF FF FF FF FF 	FF FF FF FF FF FF FF FF 
0x780	FF FF FF FF FF FF FF FF 	FF FF FF FF FF FF FF FF 
0x790	FF FF FF FF FF FF FF FF 	FF FF FF FF FF FF FF FF 
0x7a0	FF FF FF FF FF FF FF FF 	FF FF FF FF FF FF FF FF 
0x7b0	FF FF FF FF FF FF FF FF 	FF FF FF FF FF FF FF FF 
0x7c0	FF FF FF FF FF FF FF FF 	FF FF FF FF FF FF FF FF 
0x7d0	FF FF FF FF FF FF FF FF 	FF FF FF FF FF FF FF FF 
0x7e0	FF FF FF FF FF FF FF FF 	FF FF FF FF FF FF FF FF 
0x7f0	FF FF FF FF FF FF FF FF 	FF FF FF FF FF FF FF FF 
